3..*........
...*....*..4
............
*......*...1
..a.........
....*.......
....*.......
3...*......*
3..*........
......4....b
..*......***
4...........