.......b
...*....
*..*a...
.......3
........
...2.*..
....*.1.
344**..0
