..3*........
...*....*..4
............
*.....0*...*
..a........3
....*....1..
.3..*......*
....*.....0.
...*.......*
......4....b
..*......*..
1..**...2..2