3......b
...*....
*..*a...
..1....3
........
...2.*..
....*.1.
344**..0
