....0..*...*...
*..............
...*.a...*....*
........A...a..
.a....*........
...***....*...*
.*.*...........
........*......
.0.*......*.*..
.........a..2..
.*....*.*..**..
.....*.........
..*.......*....
.4.....*.......
....*....*....*