4.......2.
....1.*...
*.....*...
..*.....*.
......A..a
.*......*.
.0...*....
..*......4
..a....*..
..*...*...
